########
#..# # #
#.## ###
#... ###
########
#
#
#
#